#####################
f.#f#.......#.......#
#.#.#.#####.#.#.###.#
#...#.#...#...#.#...#
#.#.#.#.#.#####.#.###
#.#.#.#.#.#.....#...#
#.#.#.#.#.#.#.###.###
#.#...#.#.#.#..f#...#
#.##.##.#...#.#####.#
#.......#.#.#.......#
#.#####.###.#####.#.#
#.......#...#.#...#.#
#.#######.###.#.###.#
#...#...#...#.....#.#
###.#.#.###.##.##.###
#...#.#..f#.#...#...#
#.###.#.###.#.#.###.#
#...#.#.#.....#.#.#.#
###.#.#.#.#####.#.#.#
#.....#...#.....#..s#
#####################