#####################
#s..................#
#...................#
#...................#
#...................#
#..............f....#
#.....f.............#
#............f......#
#.......f...........#
#..........f........#
#...................#
#........f..........#
#...........f.......#
#......f............#
#.............f.....#
#....f..............#
#...................#
#...................#
#...................#
#..................f#
#####################