#####################
#.....#...#...#.#...#
#s###.#.#.#...#.#.#.#
#...#.#.#.#...#...#.#
#...#.#.#.#####.#.#f#
#...#...#.#.....#.###
###.###.#.#########f#
#.#...#...........#.#
#.#.#....####.#.#.#.#
#...#.....#...#.#...#
#####.###.#.#.#######
#.....#...#.#.......#
#.#####.###.#.......#
#.#...#.....#.......#
#.#.#.#.#####.#####.#
#.#.#.......#.#.....#
#.#.#######.#.#.#.###
#.....#...#.#.#.#.#.#
###.#.#.#.###...#.#.#
#f..#.#.#.......#...f
#####################